{"StartLocations":
    [
    [1,1,1,1,1,1,1,1,1,1,1,1,1,1,1,1,1,1,1,1],
    [1,0,0,0,0,0,0,0,0,0,0,0,0,0,0,0,0,0,3,1],
    [1,1,0,1,0,1,1,1,1,1,1,1,0,1,0,1,1,1,1,1],
    [1,0,0,1,0,0,0,0,0,0,0,1,0,1,0,0,0,0,0,1],
    [1,1,0,0,0,1,1,1,1,1,1,1,0,1,0,1,1,1,1,1],
    [1,0,0,1,0,0,0,0,0,1,1,0,0,1,0,1,0,0,0,1],
    [1,0,1,0,0,1,1,1,0,1,1,0,1,0,0,1,1,1,0,5],
    [1,0,1,1,0,1,0,1,1,1,1,0,1,1,0,0,0,1,0,5],
    [1,0,1,0,0,0,0,0,1,0,1,0,0,0,0,1,0,1,0,5],
    [1,0,0,0,0,0,1,0,0,1,1,1,0,1,0,1,0,0,0,1],
    [1,1,0,1,1,1,1,1,1,1,1,1,0,1,1,1,1,1,1,1],
    [1,0,0,0,0,0,0,0,0,0,0,0,0,0,0,0,0,0,0,1],
    [1,1,0,1,0,1,0,1,1,1,1,1,0,1,0,1,1,1,1,1],
    [1,0,0,1,0,1,0,0,0,0,0,0,0,1,0,0,0,0,0,1],
    [1,1,0,1,0,1,0,1,1,1,0,1,0,0,0,1,1,1,1,1],
    [1,0,0,1,0,1,0,0,0,1,0,0,0,1,0,1,0,0,0,1],
    [1,1,0,1,0,1,2,1,0,1,0,1,0,0,0,1,1,1,0,1],
    [1,1,0,1,0,1,1,1,0,1,0,1,1,1,0,1,0,1,0,1],
    [1,0,0,0,0,0,0,0,0,1,0,0,0,0,0,0,0,0,0,1],
    [1,1,1,1,1,1,1,1,1,1,1,1,1,1,1,1,1,1,1,1]
    ]
  ,"ExitLocation":{"HeightFromAnchor":80,"SidePlaced":3,"Length":80}}